5
5
11111
12031
11111
11111
11111
5
11111
12011
11111
11311
11111
5
20000
01110
01030
01110
00000
5
23000
11111
11111
11111
11111
5
00000
00100
02130
00100
00000
